time,population_size,deaths,births,sex_f,sex_m,bt_pt-O,bt_pt-A,bt_pt-B,bt_pt-AB,btrf_pt-O+,btrf_pt-A+,btrf_pt-B+,btrf_pt-AB+,btrf_pt-O-,btrf_pt-A-,btrf_pt-B-,btrf_pt-AB-,[0.0-10.0),[10.0-20.0),[20.0-30.0),[30.0-40.0),[40.0-50.0),[50.0-60.0),[60.0-70.0),[70.0-80.0),[80.0-90.0),[90.0-100.0),[100.0)
1,20003,263,266,10006,9997,20003,0,0,0,20003,0,0,0,0,0,0,0,3890,3963,3917,3954,3879,400,0,0,0,0,0
2,20006,263,266,10023,9983,20006,0,0,0,20006,0,0,0,0,0,0,0,3761,3965,3859,3890,3798,733,0,0,0,0,0
3,20008,263,265,10034,9974,20008,0,0,0,20008,0,0,0,0,0,0,0,3643,3904,3867,3828,3704,1062,0,0,0,0,0
4,20011,263,266,10025,9986,20011,0,0,0,20011,0,0,0,0,0,0,0,3465,3925,3841,3761,3665,1354,0,0,0,0,0
5,20013,263,265,10027,9986,20013,0,0,0,20013,0,0,0,0,0,0,0,3314,3915,3762,3813,3570,1639,0,0,0,0,0
6,20014,264,265,10042,9972,20014,0,0,0,20014,0,0,0,0,0,0,0,3162,3883,3779,3769,3553,1868,0,0,0,0,0
7,20016,263,265,10042,9974,20016,0,0,0,20016,0,0,0,0,0,0,0,3058,3810,3793,3765,3476,2114,0,0,0,0,0
8,20018,263,265,10052,9966,20018,0,0,0,20018,0,0,0,0,0,0,0,2903,3832,3744,3788,3392,2359,0,0,0,0,0
9,20020,264,266,10058,9962,20020,0,0,0,20020,0,0,0,0,0,0,0,2743,3822,3776,3729,3397,2553,0,0,0,0,0
10,20022,264,266,10083,9939,20022,0,0,0,20022,0,0,0,0,0,0,0,2593,3856,3764,3694,3403,2712,0,0,0,0,0
11,20024,264,266,10074,9950,20024,0,0,0,20024,0,0,0,0,0,0,0,2591,3712,3770,3688,3330,2710,223,0,0,0,0
12,20026,264,266,10070,9956,20026,0,0,0,20026,0,0,0,0,0,0,0,2592,3591,3787,3630,3338,2684,404,0,0,0,0
13,20028,264,266,10058,9970,20028,0,0,0,20028,0,0,0,0,0,0,0,2598,3480,3741,3661,3319,2653,576,0,0,0,0
14,20030,264,266,10049,9981,20030,0,0,0,20030,0,0,0,0,0,0,0,2604,3306,3774,3644,3312,2663,727,0,0,0,0
15,20032,264,266,10052,9980,20032,0,0,0,20032,0,0,0,0,0,0,0,2615,3166,3769,3579,3383,2629,891,0,0,0,0
16,20034,264,266,10055,9979,20034,0,0,0,20034,0,0,0,0,0,0,0,2617,3027,3752,3608,3359,2675,996,0,0,0,0
17,20036,264,266,10048,9988,20036,0,0,0,20036,0,0,0,0,0,0,0,2614,2942,3669,3637,3374,2654,1146,0,0,0,0
18,20038,264,266,10055,9983,20038,0,0,0,20038,0,0,0,0,0,0,0,2618,2803,3697,3603,3401,2625,1291,0,0,0,0
19,20040,264,266,10042,9998,20040,0,0,0,20040,0,0,0,0,0,0,0,2621,2645,3701,3640,3354,2680,1399,0,0,0,0
20,20042,264,266,10000,10042,20042,0,0,0,20042,0,0,0,0,0,0,0,2621,2499,3743,3635,3351,2724,1469,0,0,0,0
21,20044,264,266,10001,10043,20044,0,0,0,20044,0,0,0,0,0,0,0,2622,2495,3608,3633,3360,2716,1524,86,0,0,0
22,20046,264,266,9982,10064,20046,0,0,0,20046,0,0,0,0,0,0,0,2624,2501,3487,3656,3323,2741,1551,163,0,0,0
23,20048,264,266,9980,10068,20048,0,0,0,20048,0,0,0,0,0,0,0,2623,2513,3383,3621,3345,2755,1589,219,0,0,0
24,20050,264,266,9958,10092,20050,0,0,0,20050,0,0,0,0,0,0,0,2625,2526,3213,3660,3359,2744,1652,271,0,0,0
25,20052,264,266,9965,10087,20052,0,0,0,20052,0,0,0,0,0,0,0,2630,2535,3076,3658,3312,2818,1661,362,0,0,0
26,20054,264,266,9948,10106,20054,0,0,0,20054,0,0,0,0,0,0,0,2629,2545,2941,3649,3354,2819,1712,405,0,0,0
27,20056,264,266,9961,10095,20056,0,0,0,20056,0,0,0,0,0,0,0,2630,2550,2862,3571,3406,2828,1759,450,0,0,0
28,20058,264,266,9974,10084,20058,0,0,0,20058,0,0,0,0,0,0,0,2630,2564,2722,3600,3375,2865,1766,536,0,0,0
29,20060,264,266,9964,10096,20060,0,0,0,20060,0,0,0,0,0,0,0,2629,2568,2572,3608,3410,2847,1822,604,0,0,0
30,20062,264,266,9985,10077,20062,0,0,0,20062,0,0,0,0,0,0,0,2633,2565,2437,3647,3407,2877,1849,647,0,0,0
31,20064,264,266,9975,10089,20064,0,0,0,20064,0,0,0,0,0,0,0,2635,2569,2440,3522,3422,2915,1845,701,15,0,0
32,20066,264,266,9972,10094,20066,0,0,0,20066,0,0,0,0,0,0,0,2640,2573,2452,3400,3458,2894,1882,736,31,0,0
33,20068,264,266,9972,10096,20068,0,0,0,20068,0,0,0,0,0,0,0,2642,2576,2472,3295,3444,2907,1932,768,32,0,0
34,20070,264,266,9973,10097,20070,0,0,0,20070,0,0,0,0,0,0,0,2643,2575,2487,3122,3488,2952,1955,805,43,0,0
35,20072,265,267,9970,10102,20072,0,0,0,20072,0,0,0,0,0,0,0,2642,2585,2497,2993,3490,2923,2029,847,66,0,0
36,20075,264,267,9970,10105,20075,0,0,0,20075,0,0,0,0,0,0,0,2645,2588,2507,2866,3475,2988,2055,893,58,0,0
37,20077,264,266,9970,10107,20077,0,0,0,20077,0,0,0,0,0,0,0,2646,2591,2510,2799,3402,3052,2096,917,64,0,0
38,20079,264,266,9978,10101,20079,0,0,0,20079,0,0,0,0,0,0,0,2648,2587,2519,2663,3436,3049,2156,946,75,0,0
39,20081,264,266,9976,10105,20081,0,0,0,20081,0,0,0,0,0,0,0,2653,2588,2523,2529,3452,3098,2176,983,79,0,0
40,20083,265,267,9967,10116,20083,0,0,0,20083,0,0,0,0,0,0,0,2654,2589,2522,2398,3489,3110,2202,1025,94,0,0
41,20086,264,267,9970,10116,20086,0,0,0,20086,0,0,0,0,0,0,0,2653,2594,2528,2399,3369,3141,2254,1040,108,0,0
42,20088,264,266,9961,10127,20088,0,0,0,20088,0,0,0,0,0,0,0,2650,2596,2533,2413,3254,3172,2246,1097,127,0,0
43,20090,264,266,9949,10141,20090,0,0,0,20090,0,0,0,0,0,0,0,2648,2603,2533,2432,3163,3153,2282,1152,124,0,0
44,20093,264,267,9951,10142,20093,0,0,0,20093,0,0,0,0,0,0,0,2650,2607,2536,2451,2998,3191,2334,1198,128,0,0
45,20095,265,267,9947,10148,20095,0,0,0,20095,0,0,0,0,0,0,0,2653,2608,2544,2460,2887,3193,2334,1281,135,0,0
46,20097,265,267,9928,10169,20097,0,0,0,20097,0,0,0,0,0,0,0,2648,2610,2549,2468,2773,3190,2400,1313,146,0,0
47,20100,264,267,9930,10170,20100,0,0,0,20100,0,0,0,0,0,0,0,2649,2615,2550,2471,2713,3122,2471,1359,150,0,0
48,20102,265,267,9930,10172,20102,0,0,0,20102,0,0,0,0,0,0,0,2651,2614,2554,2478,2596,3156,2488,1403,162,0,0
49,20104,265,267,9938,10166,20104,0,0,0,20104,0,0,0,0,0,0,0,2651,2618,2556,2483,2464,3178,2531,1441,182,0,0
50,20106,265,267,9930,10176,20106,0,0,0,20106,0,0,0,0,0,0,0,2655,2622,2559,2484,2343,3240,2522,1479,202,0,0
51,20108,265,267,9949,10159,20108,0,0,0,20108,0,0,0,0,0,0,0,2654,2625,2563,2488,2352,3139,2540,1530,217,0,0
52,20110,265,267,9959,10151,20110,0,0,0,20110,0,0,0,0,0,0,0,2661,2620,2572,2495,2360,3058,2578,1529,237,0,0
53,20112,265,267,9958,10154,20112,0,0,0,20112,0,0,0,0,0,0,0,2664,2621,2579,2493,2378,2969,2580,1560,268,0,0
54,20114,265,267,9965,10149,20114,0,0,0,20114,0,0,0,0,0,0,0,2662,2620,2586,2499,2395,2822,2666,1586,278,0,0
55,20116,265,267,9974,10142,20116,0,0,0,20116,0,0,0,0,0,0,0,2661,2626,2587,2519,2398,2728,2687,1592,318,0,0
56,20118,265,267,9986,10132,20118,0,0,0,20118,0,0,0,0,0,0,0,2660,2628,2586,2528,2410,2624,2692,1666,324,0,0
57,20120,265,267,9976,10144,20120,0,0,0,20120,0,0,0,0,0,0,0,2664,2628,2593,2530,2411,2579,2658,1711,346,0,0
58,20122,265,267,9960,10162,20122,0,0,0,20122,0,0,0,0,0,0,0,2665,2633,2596,2537,2412,2470,2697,1735,377,0,0
59,20124,265,267,9949,10175,20124,0,0,0,20124,0,0,0,0,0,0,0,2663,2636,2601,2540,2423,2346,2747,1779,389,0,0
60,20126,265,267,9968,10158,20126,0,0,0,20126,0,0,0,0,0,0,0,2664,2638,2606,2542,2425,2242,2825,1779,404,1,0
61,20128,265,267,9960,10168,20128,0,0,0,20128,0,0,0,0,0,0,0,2661,2639,2608,2550,2433,2247,2742,1819,427,2,0
62,20130,265,267,9955,10175,20130,0,0,0,20130,0,0,0,0,0,0,0,2660,2643,2603,2559,2446,2250,2657,1881,430,1,0
63,20132,265,267,9946,10186,20132,0,0,0,20132,0,0,0,0,0,0,0,2660,2644,2603,2563,2449,2272,2569,1915,456,1,0
64,20134,265,267,9967,10167,20134,0,0,0,20134,0,0,0,0,0,0,0,2662,2641,2606,2570,2457,2292,2447,1986,472,1,0
65,20137,265,268,9975,10162,20137,0,0,0,20137,0,0,0,0,0,0,0,2665,2637,2612,2569,2480,2299,2384,1997,492,2,0
66,20139,265,267,9990,10149,20139,0,0,0,20139,0,0,0,0,0,0,0,2663,2637,2613,2573,2488,2322,2293,2013,536,1,0
67,20142,265,268,10010,10132,20142,0,0,0,20142,0,0,0,0,0,0,0,2664,2642,2610,2579,2494,2324,2264,2008,556,1,0
68,20144,265,267,10017,10127,20144,0,0,0,20144,0,0,0,0,0,0,0,2663,2644,2608,2581,2496,2324,2174,2079,574,1,0
69,20146,265,267,10018,10128,20146,0,0,0,20146,0,0,0,0,0,0,0,2666,2642,2610,2586,2503,2323,2082,2127,606,1,0
70,20148,265,267,10019,10129,20148,0,0,0,20148,0,0,0,0,0,0,0,2666,2646,2613,2587,2503,2330,2007,2192,603,1,0
71,20150,265,267,10023,10127,20150,0,0,0,20150,0,0,0,0,0,0,0,2666,2647,2616,2588,2514,2340,2014,2134,630,1,0
72,20153,265,268,10039,10114,20153,0,0,0,20153,0,0,0,0,0,0,0,2668,2648,2624,2580,2525,2354,2027,2075,651,1,0
73,20155,265,267,10051,10104,20155,0,0,0,20155,0,0,0,0,0,0,0,2667,2648,2627,2585,2528,2358,2056,2023,662,1,0
74,20157,265,267,10051,10106,20157,0,0,0,20157,0,0,0,0,0,0,0,2665,2649,2628,2588,2530,2370,2069,1936,720,2,0
75,20158,266,267,10031,10127,20158,0,0,0,20158,0,0,0,0,0,0,0,2661,2653,2625,2591,2532,2383,2088,1879,745,1,0
76,20160,265,267,10035,10125,20160,0,0,0,20160,0,0,0,0,0,0,0,2661,2648,2626,2597,2532,2396,2108,1826,763,3,0
77,20162,265,267,10061,10101,20162,0,0,0,20162,0,0,0,0,0,0,0,2662,2650,2628,2596,2546,2403,2106,1825,744,2,0
78,20164,265,267,10061,10103,20164,0,0,0,20164,0,0,0,0,0,0,0,2664,2649,2632,2595,2552,2410,2109,1761,789,3,0
79,20167,265,268,10059,10108,20167,0,0,0,20167,0,0,0,0,0,0,0,2665,2651,2629,2592,2556,2422,2100,1720,825,7,0
80,20168,266,267,10061,10107,20168,0,0,0,20168,0,0,0,0,0,0,0,2666,2653,2632,2596,2559,2410,2112,1668,871,1,0
81,20170,265,267,10066,10104,20170,0,0,0,20170,0,0,0,0,0,0,0,2667,2651,2633,2598,2555,2426,2130,1656,849,5,0
82,20172,266,268,10060,10112,20172,0,0,0,20172,0,0,0,0,0,0,0,2666,2652,2636,2607,2544,2443,2138,1668,814,4,0
83,20175,265,268,10032,10143,20175,0,0,0,20175,0,0,0,0,0,0,0,2666,2653,2636,2605,2544,2445,2144,1708,771,3,0
84,20177,266,268,10037,10140,20177,0,0,0,20177,0,0,0,0,0,0,0,2669,2652,2636,2606,2551,2436,2166,1719,739,3,0
85,20179,266,268,10061,10118,20179,0,0,0,20179,0,0,0,0,0,0,0,2670,2653,2638,2604,2547,2438,2170,1743,713,3,0
86,20181,266,268,10060,10121,20181,0,0,0,20181,0,0,0,0,0,0,0,2673,2652,2635,2604,2549,2434,2195,1736,703,0,0
87,20183,266,268,10071,10112,20183,0,0,0,20183,0,0,0,0,0,0,0,2673,2654,2639,2611,2545,2453,2193,1726,683,6,0
88,20185,266,268,10066,10119,20185,0,0,0,20185,0,0,0,0,0,0,0,2676,2651,2640,2613,2546,2458,2197,1729,669,6,0
89,20187,266,268,10070,10117,20187,0,0,0,20187,0,0,0,0,0,0,0,2675,2653,2644,2610,2549,2454,2206,1725,667,4,0
90,20189,266,268,10072,10117,20189,0,0,0,20189,0,0,0,0,0,0,0,2677,2652,2644,2612,2554,2456,2201,1739,648,6,0
91,20191,266,268,10064,10127,20191,0,0,0,20191,0,0,0,0,0,0,0,2677,2653,2643,2617,2554,2452,2206,1735,654,0,0
92,20193,266,268,10080,10113,20193,0,0,0,20193,0,0,0,0,0,0,0,2677,2653,2644,2622,2559,2445,2232,1737,622,2,0
93,20195,266,268,10067,10128,20195,0,0,0,20195,0,0,0,0,0,0,0,2675,2654,2642,2621,2564,2449,2234,1731,625,0,0
94,20197,266,268,10082,10115,20197,0,0,0,20197,0,0,0,0,0,0,0,2675,2655,2641,2620,2566,2459,2204,1751,626,0,0
95,20199,266,268,10073,10126,20199,0,0,0,20199,0,0,0,0,0,0,0,2676,2660,2638,2622,2569,2456,2218,1738,618,4,0
96,20201,266,268,10067,10134,20201,0,0,0,20201,0,0,0,0,0,0,0,2677,2660,2637,2619,2574,2460,2206,1747,620,1,0
97,20203,266,268,10061,10142,20203,0,0,0,20203,0,0,0,0,0,0,0,2675,2659,2635,2624,2579,2456,2222,1743,609,1,0
98,20205,266,268,10062,10143,20205,0,0,0,20205,0,0,0,0,0,0,0,2675,2657,2633,2629,2578,2452,2226,1747,606,2,0
99,20207,266,268,10074,10133,20207,0,0,0,20207,0,0,0,0,0,0,0,2675,2660,2632,2633,2573,2465,2218,1752,598,1,0
100,20209,266,268,10081,10128,20209,0,0,0,20209,0,0,0,0,0,0,0,2675,2662,2633,2628,2574,2468,2217,1744,606,2,0
